9 12 9 9 9 9 9 9 11 11 
9 9 10 9 13 10 9 10 9 11 
11 11 9 9 9 9 11 9 9 9 
11 15 11 9 9 11 11 9 12 10 
11 9 9 10 9 11 16 9 9 9 
9 9 12 9 9 9 11 11 9 9 
9 14 18 9 11 11 11 11 19 11
7 -1 -1 -1 -1 -1 -1 -1 -1 -1 
-1 -1 -1 -1 6 -1 -1 8 -1 -1 
-1 -1 -1 -1 -1 -1 -1 -1 -1 -1 
-1 -1 -1 -1 -1 -1 -1 -1 -1 -1 
-1 -1 -1 -1 -1 -1 -1 -1 -1 -1 
-1 -1 -1 5 -1 -1 -1 -1 9 -1 
-1 -1 -1 -1 -1 -1 -1 -1 -1 -1