20 20 20 20 21 20 20 21 20 27 
20 23 20 20 20 24 25 25 25 25 
20 20 20 21 20 20 20 21 20 20 
20 20 24 25 25 25 26 20 23 20 
20 21 20 20 20 20 21 20 20 20 
25 26 20 20 24 25 25 25 25 25 
26 20 21 20 20 20 22 21 20 24
-1 -1 -1 -1 -1 10 -1 -1 -1 -1 
-1 -1 -1 -1 -1 -1 -1 -1 -1 -1 
-1 -1 -1 -1 -1 -1 -1 -1 -1 -1 
-1 -1 -1 -1 -1 -1 -1 -1 -1 -1 
-1 11 -1 -1 -1 -1 -1 12 -1 -1 
-1 -1 -1 -1 -1 -1 -1 -1 -1 -1 
-1 -1 -1 13 -1 -1 -1 -1 -1 -1